75 0
1 7
0 0 0 0 0 0 0 0
3 2 3 1 2 1 4 1
16 8
GGGGGGGGGGGGGGGG
GPPPPPPPPPPPGGGG
GVGGPGGGGGGPPPPG
GVGGPPTTTTPPGGPG
GVGGVGGGGGGPGGPG
GPGGVGGGGGGPPPPG
GPPPPPTTTTPPGGGG
GGGGGGGGGGGGGGGG
M 4 1 T
F 2 1 T
M 6 1 T

