100
1 10
0 0 0 0 0 0 0 0
1 1 1 1 1 1 1 1
40 20
GGGGGGGGGGGGGGGGGGGGGGGGGGGGGGGGGGGGGGGG
GPPPGPPPPPPPPPPGGGGGGGGGGGGGGGGGGGGGGGGG
GPGPGPGGGGGGGGPGGGGGGGGGGGGGGGGGGGGGGGGG
GPGPGPGPPGGGPGPGGPTTTTPPPPPPPPPPPPPPPPGG
GPGTGPGGPGGGPGPGGPGGGGGGGPGGPGGPGGPGGPGG
GPGTGPPGPGGGPGPGGPGGGGGGGPGGPGGPGGPGGPGG
GPGTGGPGPGGGPGPGGPGGGGGGGPGGPPGPGGPGGPGG
GPGTGGPGPGGGPPPGGPGGGGGGGPGGGPGPGGPGGGGG
GPGTGGPGPGGGGGPGGPPPPPPGGPPPPPGPGGPGGGGG
GPGTGGPPPPPPPGPGGGGGGGPGGGGPGGGPGGPGGGGG
GPGPGGGGPGGGPGPTTTTTTTPGGGGPGGGPGGPGGPGG
GPGPPPPPPGGGPPPGGGGGGGPGGGGPGGGPGGPGGPGG
GPPPGTGGPGPGPGPGGGGGGGPGGGGPGGGPGGPGGPGG
GPGPGTGGPGPGPGPGGGGGGGPGGGGPGGGPPPPGGPGG
GPGPGTGGPGPGPPPTTTTTTPPPPPPPGGGGGGGGGPGG
GPGPGTGGPGPPPGPGGGGGGGPGGPGPGGGGGGGGGPGG
GPGPGTGGPGGPGGPGGGGGGGPGGPGPPPPTTTTPPPGG
GPGPGPGGPGGPGGPGGGGGGGPGGPGGGGGGGGGGGGGG
GPPPGPPPPGGPGGPGGGGGGGGGGPGGGGGGGGGGGGGG
GGGGGGGGGGGGGGGGGGGGGGGGGGGGGGGGGGGGGGGG
F 2 2 T
F 2 8 T
M 4 4 T
M 4 2 T
M 2 5 T