100
1 10
0 0 0 0 0 0 0 0
1 1 1 1 1 1 1 1
40 20
GGGGGGGGGGGGGGGGGGGGGGGGGGGGGGGGGGGGGGGG
GPPPGPPPPPPPPPPGGGGGGGGGGGGGGGGGGGGGGGGG
GPGPGPGGGGGGGGPGGGGGGGGGGGGGGGGGGGGGGGGG
GPGPGPGPPGGGPGPGGPTTTTPPPPPPPPPPPPPPPPGG
GPGTGPGGPGGGPGPGGPGGGGGGGPGGPGGPGGPGGPGG
GPGTGPPGPGGGPGPGGPGGGGGGGPGGPGGPGGPGGPGG
GPGTGGPGPGGGPGPGGPGGGGGGGPGGPPGPGGPGGPGG
GPGTGGPGPGGGPPPGGPGGGGGGGPGGGPGPGGPGGGGG
GPGTGGPGPGGGGGPGGPPPPPPGGPPPPPGPGGPGGGGG
GPGTGGPPPPPPPGPGGGGGGGPGGGGPGGGPGGPGGGGG
GPGPGGGGPGGGPGPTTTTTTTPGGGGPGGGPGGPGGPGG
GPGPPPPPPGGGPPPGGGGGGGPGGGGPGGGPGGPGGPGG
GPPPGTGGPGPGPGPGGGGGGGPGGGGPGGGPGGPGGPGG
GPGPGTGGPGPGPGPGGGGGGGPGGGGPGGGPPPPGGPGG
GPGPGTGGPGPGPPPTTTTTTPPPPPPPGGGGGGGGGPGG
GPGPGTGGPGPPPGPGGGGGGGPGGPGPGGGGGGGGGPGG
GPGPGTGGPGGPGGPGGGGGGGPGGPGPPPPTTTTPPPGG
GPGPGPGGPGGPGGPGGGGGGGPGGPGGGGGGGGGGGGGG
GPPPGPPPPGGPGGPGGGGGGGGGGPGGGGGGGGGGGGGG
GGGGGGGGGGGGGGGGGGGGGGGGGGGGGGGGGGGGGGGG
F 1 2 T
F 1 7 T
M 3 3 T
M 3 1 T
M 1 4 T