100
1 10
0 0 0 0 0 0 0 0
1 1 1 1 1 1 1 1
40 20
GGGGGGGGGGGGGGGGGGGGGGGGGGGGGGGGGGGGGGGG
GPPPGPPPPPPPPPPGGGGGGGGGGGGGGGGGGGGGGGGG
GPGPGPGGGGGGGGPGGGGGGGGGGGGGGGGGGGGGGGGG
GPGPGPGPPGGGPGPGGPTTTTPPPPPPPPPPPPPPPPGG
GPGVGPGGPGGGPGPGGPGGGGGGGPGGPGGPGGPGGPGG
GPGVGPPGPGGGPGPGGPGGGGGGGPGGPGGPGGPGGPGG
GPGVGGPGPGGGPGPGGPGGGGGGGPGGPPGPGGPGGPGG
GPGVGGPGPGGGPPPGGPGGGGGGGPGGGPGPGGPGGGGG
GPGVGGPGPGGGGGPGGPPPPPPGGPPPPPGPGGPGGGGG
GPGVGGPPPPPPPGPGGGGGGGPGGGGPGGGPGGPGGGGG
GPGPGGGGPGGGPGPTTTTTTTPGGGGPGGGPGGPGGPGG
GPGPPPPPPGGGPPPGGGGGGGPGGGGPGGGPGGPGGPGG
GPPPGVGGPGPGPGPGGGGGGGPGGGGPGGGPGGPGGPGG
GPGPGVGGPGPGPGPGGGGGGGPGGGGPGGGPPPPGGPGG
GPGPGVGGPGPGPPPTTTTTTPPPPPPPGGGGGGGGGPGG
GPGPGVGGPGPPPGPGGGGGGGPGGPGPGGGGGGGGGPGG
GPGPGVGGPGGPGGPGGGGGGGPGGPGPPPPTTTTPPPGG
GPGPGPGGPGGPGGPGGGGGGGPGGPGGGGGGGGGGGGGG
GPPPGPPPPGGPGGPGGGGGGGGGGPGGGGGGGGGGGGGG
GGGGGGGGGGGGGGGGGGGGGGGGGGGGGGGGGGGGGGGG
F 1 2 T
F 1 7 T
M 3 3 T
M 3 1 T
M 1 4 T