100 0
1 10
0 0 0 0 0 0 0 0
2 3 4 5 4 3 2 1
16 8
GGGGGGGGGGGGGGGG
GPPPPPPPPPPPPPPG
GPGGGGGGGGGPGGPG
GPPPPTTTTTPPPPPG
GPGPGGGGGGGPGGPG
GPPPPTTTTTPPPPPG
GGGGGGGGGGGGGGGG
GGGGGGGGGGGGGGGG
M 4 1 T
F 2 1 T
M 6 1 T
F 1 1 T

