100
1 10
0 0 0 0 0 0 0 0
1 1 1 1 1 1 1 1
16 8
GGGGGGGGGGGGGGGG
GPPPPPPPPPPPPPPG
GGGGGGGGGGGGGGPG
GPPPPTTTTTPPPPPG
GPGGGGGGGGGGGGGG
GPPPPTTTTTPPPPPG
GGGGGGGGGGGGGGGG
GGGGGGGGGGGGGGGG
M 4 1 T
F 2 1 T
M 6 1 T
F 1 1 T

