100
1 10
0 0 0 0 0 0 0 0
1 1 1 1 1 1 1 1
16 8
GGGGGGGGGGGGGGGG
GPPPPPPTTTTPPPPG
GGPGPGGPGGGGVGPG
GGPGPPPPGGGGVGPG
GGPGGGGGGGGGVGPG
GGPPPPTTTTPPPPPG
GPPGGGGGGGGGGGGG
GGGGGGGGGGGGGGGG
M 4 1 T
F 2 1 T
M 6 1 T
F 4 2 T

