100 0
1 10
0 0 0 0 0 0 0 0
1 1 1 1 1 1 1 1
20 10
GGGGGGGGGGGGGGGGGGGG
GPPPGGGGGGGPPPPPPPPG
GPGPPTTTTPPPGGGPGGPG
GPPPGGGGGGGPGGGVGGPG
GPGPGGGGGGGPGGGVGGPG
GPPPGGGGPPPPPPPPPPPG
GPGPGGGGPGGGGGGVGGPG
GPGPPPPPPPGGGGGVGGPG
GPPPGGGGGPPPPPPPPPPG
GGGGGGGGGGGGGGGGGGGG
M 1 1 T
F 3 1 T
M 1 4 T
F 1 5 T
M 4 2 T
