100 0
1 10
0 0 0 0 0 0 0 0
1 1 1 1 1 1 1 1
20 10
GGGGGGGGGGGGGGGGGGGG
GPPPPPPPPPPPPPPPPGGG
GPGPGGGVGGGGPGGGPGGG
GPGPGGGVGGGGPGGGPGGG
GPGPPPPPPPPPPPPPPGGG
GPGPGGPGGGGGGPGGPGGG
GPGPGGPGGGGGGPGGPGGG
GPGPGGPGGGGGGPGGPGGG
GPPPPPPPPTTTTPPPPGGG
GGGGGGGGGGGGGGGGGGGG
M 2 1 T
F 6 1 T
M 1 5 T
F 1 5 T
M 3 3 T
