100
1 10
0 0 0 0 0 0 0 0
1 1 1 1 1 1 1 1
20 10
GGGGGGGGGGGGGGGGGGGG
GPPPPPPPPPPPPPPPPPPG
GPGGGGGPGGGGPGGGGGPG
GPGGGGGPTTTTPGGGGGPG
GPGGGGGPGGGGPGGGGGPG
GPPPPPPPGGGGPPPPPPPG
GPGGGGGPTTTTPGGGGGPG
GPGGGGGPGGGGPGGGGGPG
GPPPPPPPPPPPPPPPPPPG
GGGGGGGGGGGGGGGGGGGG
M 6 1 T
F 12 1 T
M 4 5 T
F 1 5 T
M 8 4 T
