100 0
1 10
0 0 0 0 0 0 0 0
1 1 1 1 1 1 1 1
40 20
GGGGGGGGGGGGGGGGGGGGGGGGGGGGGGGGGGGGGGGG
GPPPPPPPPPPPPPPGGGGGGGGGGGGGGGGGGGGGGGGG
GPGPGPGGGGGGGGPGGGGGGGGGGGGGGGGGGGGGGGGG
GPGPGPPPPPPPPGPGGPTTTTPPPPPPPPPPPPPPPPGG
GPGVGPGGPGGGPGPGGPGGGGGGGPGGPGGPGGPGGPGG
GPGVGPPGPGGGPGPGGPPPPPPPPPGGPGGPGGPGGPGG
GPGVGGPGPGGGPGPGGPGGGGGGGPGGPPGPGGPGGPGG
GPGVGGPGPGGGPPPGGPGGGGGGGPGGGPGPGGPGGVGG
GPGVGGPGPGGGGGPGGPPPPPPGGPPPPPGPPPPGGVGG
GPGVGGPPPPPPPGPGGGGGGGPGGGGPGGGPGGPGGVGG
GPGPGGGGPGGGPGPTTTTTTTPGGGGPPPPPGGPGGPGG
GPGPPPPPPGGGPPPGGGGGGGPGGGGPGGGPGGPGGPGG
GPPPGVGGPGPGPGPGGGGGGGPGGGGPGGGPGGPGGPGG
GPGPGVGGPGPGPGPGGGGGGGPGGGGPGGGPPPPGGPGG
GPGPGVGGPGPGPPPTTTTTTPPPPPPPGGGGGGGGGPGG
GPGPGVGGPGPPPGPGGGGGGGPGGPGPGGGGGGGGGPGG
GPGPGVGGPGGPGGPGGGGGGGPGGPGPPPPTTTTPPPGG
GPGPGPGGPGGPGGPGGGGGGGPGGPGGGGGGGGGGGGGG
GPPPGPPPPGGPGGPGGGGGGGGGGPGGGGGGGGGGGGGG
GGGGGGGGGGGGGGGGGGGGGGGGGGGGGGGGGGGGGGGG
F 1 2 T
F 1 7 T
M 3 3 T
M 3 1 T
M 1 4 T