100
1 10
0 0 0 0 0 0 0 0
1 1 1 1 1 1 1 1
40 20
GGGGGGGGGGGGGGGGGGGGGGGGGGGGGGGGGGGGGGGG
GPPPPPPPPPPPGPPPPPPGGPPPPPPPPPPPPPPPPPPG
GPGGGGGGGGGGGGGGGGPGGPGGGGGGGGGGGGGGGGPG
GPGGGGGGGGGGGGGGGGPGGPGGGGGGGGGGGGGGGGPG
GPGGGGGGGGGGGGGGGGPTTPGGGGGGGGGGGGGGGGPG
GPGGGGGGGGGGGGGGGGPGGPGGGGGGGGGGGGGGGGPG
GPGGGGGGGGGGGGGGGGPGGPGGGGGGGGGGGGGGGGPG
GPGGGGGGGGGGGGGGGGPGGPGGGGGGGGGGGGGGGGPG
GPPPPPPPPPPPPPPPPPPPPPPPPPPPPPPPPPPPPPPG
GGGGGGGVGGGGGGGGGGPGGGGGGGGGGGGGGGGGGGGG
GGGGGGGVGGGGGGGGGGPGGGGGGGGGGGGGGGGGGGGG
GPPPPPPPPPPPPPPPPPPGGPPPPPPPPPPPPPPPPPPG
GPGGGGGGGGGGGGGGGGPGGPGGGGGGGGGGGGGGGGPG
GPGGGGGGGGGGGGGGGGPGGPGGGGGGGGGGGGGGGGPG
GPGGGGGGGGGGGGGGGGPTTPGGGGGGGGGGGGGGGGPG
GPGGGGGGGGGGGGGGGGPGGPGGGGGGGGGGGGGGGGPG
GPGGGGGGGGGGGGGGGGPGGPGGGGGGGGGGGGGGGGPG
GPGGGGGGGGGGGGGGGGPGGPGGGGGGGGGGGGGGGGPG
GPPPPPPPPPPPPPPPPPPGGPPPPPPPPPPPPPPPPPPG
GGGGGGGGGGGGGGGGGGGGGGGGGGGGGGGGGGGGGGGG
F 3 1 T
M 1 3 T
M 4 1 T
F 5 1 T
M 9 1 T
M 3 1 T
