100
1 10
0 0 0 0 0 0 0 0
10 10 10 10 10 10 10 10
40 20
GGGGGGGGGGGGGGGGGGGGGGGGGGGGGGGGGGGGGGGG
GPGPPGPPPPGPGPPPPPPGGPPPPPPPPPPPPPPPPPPG
GPGGGGGGGGGGGGGGGGPGGPGGGGGGGGGGGGGGGGPG
GPGGGGGGGGGGGGGGGGPGGPGGGGGGGGGGGGGGGGPG
GPGGGGGGGGGGGGGGGGPTTPGGGGGGGGGGGGGGGGPG
GPGGGGGGGGGGGGGGGGPGGPGGGGGGGGGGGGGGGGPG
GPGGGGGGGGGGGGGGGGPGGPGGGGGGGGGGGGGGGGPG
GPGGGGGGGGGGGGGGGGPGGPGGGGGGGGGGGGGGGGPG
GPPPPPPPPPPPPPPPPPPGGPPPPPPPPPPPPPPPPPPG
GGGGGGGVGGGGGGGGGGGGGGGGGGGGGGGGGGGGGGGG
GGGGGGGVGGGGGGGGGGGGGGGGGGGGGGGGGGGGGGGG
GPPPPPPPPPPPPPPPPPPGGPPPPPPPPPPPPPPPPPPG
GPGGGGGGGGGGGGGGGGPGGPGGGGGGGGGGGGGGGGPG
GPGGGGGGGGGGGGGGGGPGGPGGGGGGGGGGGGGGGGPG
GPGGGGGGGGGGGGGGGGPTTPGGGGGGGGGGGGGGGGPG
GPGGGGGGGGGGGGGGGGPGGPGGGGGGGGGGGGGGGGPG
GPGGGGGGGGGGGGGGGGPGGPGGGGGGGGGGGGGGGGPG
GPGGGGGGGGGGGGGGGGPGGPGGGGGGGGGGGGGGGGPG
GPPPPPPPPPPPPPPPPPPGGPPPPPPPPPPPPPPPPPPG
GGGGGGGGGGGGGGGGGGGGGGGGGGGGGGGGGGGGGGGG
F 11 1 T