40 20
10 10 10 10 10 10 10 10
GGGGGGGGGGGGGGGGGGGGGGGGGGGGGGGGGGGGGGGG
GPPPPPPPPPPPGPPPPPPGGPPPPPPPPPPPPPPPPPPG
GPGGGGGGGGGGGGGGGGPGGPGGGGGGGGGGGGGGGGPG
GPGGGGGGGGGGGGGGGGPGGPGGGGGGGGGGGGGGGGPG
GPGGGGGGGGGGGGGGGGPTTPGGGGGGGGGGGGGGGGPG
GPGGGGGGGGGGGGGGGGPGGPGGGGGGGGGGGGGGGGPG
GPGGGGGGGGGGGGGGGGPGGPGGGGGGGGGGGGGGGGPG
GPGGGGGGGGGGGGGGGGPGGPGGGGGGGGGGGGGGGGPG
GPPPPPPPPPPPPPPPPPPGGPPPPPPPPPPPPPPPPPPG
GGGGGGGVGGGGGGGGGGGGGGGGGGGGGGGGGGGGGGGG
GGGGGGGVGGGGGGGGGGGGGGGGGGGGGGGGGGGGGGGG
GPPPPPPPPPPPPPPPPPPGGPPPPPPPPPPPPPPPPPPG
GPGGGGGGGGGGGGGGGGPGGPGGGGGGGGGGGGGGGGPG
GPGGGGGGGGGGGGGGGGPGGPGGGGGGGGGGGGGGGGPG
GPGGGGGGGGGGGGGGGGPTTPGGGGGGGGGGGGGGGGPG
GPGGGGGGGGGGGGGGGGPGGPGGGGGGGGGGGGGGGGPG
GPGGGGGGGGGGGGGGGGPGGPGGGGGGGGGGGGGGGGPG
GPGGGGGGGGGGGGGGGGPGGPGGGGGGGGGGGGGGGGPG
GPPPPPPPPPPPPPPPPPPGGPPPPPPPPPPPPPPPPPPG
GGGGGGGGGGGGGGGGGGGGGGGGGGGGGGGGGGGGGGGG

GGGGGGGGGGGGGGGGGGGGGGGGGGGGGGGGGGGGGGGG
GPPFPPPPPPPPGPPPPPPGGPPPPPPPPPPPPPPPPPPG
GPGGGGGGGGGGGGGGGGPGGPGGGGGGGGGGGGGGGGPG
GPGGGGGGGGGGGGGGGGPGGPGGGGGGGGGGGGGGGGPG
GPGGGGGGGGGGGGGGGGPTTPGGGGGGGGGGGGGGGGPG
GPGGGGGGGGGGGGGGGGPGGPGGGGGGGGGGGGGGGGPG
GPGGGGGGGGGGGGGGGGPGGPGGGGGGGGGGGGGGGGPG
GPGGGGGGGGGGGGGGGGPGGPGGGGGGGGGGGGGGGGPG
GPPPPPPPPPPPPPPPPPPGGPPPPPPFPPPPPPPPPPPG
GGGGGGGVGGGGGGGGGGGGGGGGGGGGGGGGGGGGGGGG
GGGGGGGVGGGGGGGGGGGGGGGGGGGGGGGGGGGGGGGG
GPPPPMPPPPPPPPPPPPPGGPPPPPPPMPPPPPPPPPPG
GPGGGGGGGGGGGGGGGGPGGPGGGGGGGGGGGGGGGGPG
GPGGGGGGGGGGGGGGGGPGGPGGGGGGGGGGGGGGGGPG
GPGGGGGGGGGGGGGGGGPTTPGGGGGGGGGGGGGGGGPG
GPGGGGGGGGGGGGGGGGPGGPGGGGGGGGGGGGGGGGPG
GPGGGGGGGGGGGGGGGGPGGPGGGGGGGGGGGGGGGGPG
GPGGGGGGGGGGGGGGGGPGGPGGGGGGGGGGGGGGGGPG
GPPPPPPPPPPPPPPPPPPGGPPPPPPPPPPPPPPPPPPG
GGGGGGGGGGGGGGGGGGGGGGGGGGGGGGGGGGGGGGGG