40 10
GGGGGGGGGGGGGGGGGGGGGGGGGGGGGGGGGGGGGGGG
GPPPPPPPPPPPPPPPPPPGGPPPPPPPPPPPPPPPPPPG
GPGGGGGGGGGGGGGGGGPGGPGGGGGGGGGGGGGGGGPG
GPGGGGGGGGGGGGGGGGPGGPGGGGGGGGGGGGGGGGPG
GPGGGGGGGGGGGGGGGGPTTPGGGGGGGGGGGGGGGGPG
GPGGGGGGGGGGGGGGGGPGGPGGGGGGGGGGGGGGGGPG
GPGGGGGGGGGGGGGGGGPGGPGGGGGGGGGGGGGGGGPG
GPGGGGGGGGGGGGGGGGPGGPGGGGGGGGGGGGGGGGPG
GPPPPPPPPPPPPPPPPPPGGPPPPPPPPPPPPPPPPPPG
GGGGGGGVGGGGGGGGGGGGGGGGGGGGGGGGGGGGGGGG
