20 10
GGGGGGGGGGGGGGGGGGGG
GPPPPPPPPPPPPPPPPPPG
GPGGGGGGGGGGGGGGGGPG
GPGGGGGGGGGGGGGGGGPG
GPGGGGGGGGGGGGGGGGPT
GPGGGGGGGGGGGGGGGGPG
GPGGGGGGGGGGGGGGGGPG
GPGGGGGGGGGGGGGGGGPG
GPPPPPPPPPPPPPPPPPPG
GGGGGGGVGGGGGGGGGGGG
